#######################################
# Syntax Coloring Map for SkalenGenerator
#######################################

# Classes
SkalenGenerator	KEYWORD1

# Methods
generateScale	KEYWORD2
getScaleInfo	KEYWORD2
printAvailableScales	KEYWORD2

# Scale Types (Constants)
IONIAN	LITERAL1
AEOLIAN	LITERAL1
DORIAN	LITERAL1
PHRYGIAN	LITERAL1
LYDIAN	LITERAL1
MIXOLYDIAN	LITERAL1
LOCRIAN	LITERAL1
MELODIC_MINOR	LITERAL1
HARMONIC_MINOR	LITERAL1
BLUES	LITERAL1
BEBOP_DOMINANT	LITERAL1
BEBOP_MAJOR	LITERAL1
PENTATONIC	LITERAL1
WHOLE_TONE	LITERAL1
ALTERED	LITERAL1
DIMINISHED	LITERAL1
HALF_DIMINISHED	LITERAL1
SCALE_COUNT	LITERAL1

# Metadata Struct
ScaleInfo	KEYWORD1
id	KEYWORD2
name	KEYWORD2
intervals	KEYWORD2
chords	KEYWORD2
